2 2 2 2 2 2 2 2 2 2 2 2 2 2 2 2 2 2 2 2 2 2 2 2 2 2 2 2 2 2 2 2 2 2 2 2 2 2 2 2 2 2 2 2 2 2 2 2 2 2
2 2 2 3 3 0 0 0 0 0 0 0 0 0 0 3 3 3 3 3 3 3 3 3 3 3 3 3 3 3 3 3 3 3 0 0 0 0 0 0 0 0 0 0 0 3 2 2 2 2
2 2 3 0 0 0 0 0 0 0 0 0 0 0 0 0 3 3 3 3 3 3 3 3 3 3 3 3 3 3 3 0 0 0 0 0 0 0 0 0 0 0 0 0 0 0 3 2 2 2
2 3 0 0 0 0 0 0 0 0 3 3 3 0 0 0 0 0 3 3 3 3 3 3 3 3 3 0 0 0 0 0 0 0 0 0 2 2 2 2 2 2 2 0 0 0 0 3 2 2
2 2 3 3 3 3 3 3 3 3 3 3 2 2 2 0 0 0 0 0 0 3 3 3 3 3 0 0 0 0 0 0 2 2 2 2 2 3 2 2 2 2 2 0 0 0 0 3 3 2
2 2 3 3 3 3 3 3 2 2 2 2 2 2 2 2 2 0 0 0 0 0 0 0 0 0 0 0 2 2 2 2 2 3 3 2 0 0 0 0 0 0 0 0 0 0 0 3 3 2
2 2 2 2 2 2 2 2 2 2 1 1 1 1 2 2 2 2 2 2 0 0 0 0 0 0 0 2 2 0 3 0 0 0 0 0 0 0 0 0 0 0 0 0 0 0 0 2 2 2
2 1 2 2 1 1 1 1 1 1 1 1 1 1 1 2 2 1 1 2 2 2 2 2 0 0 2 2 0 3 0 0 0 0 0 0 0 0 0 2 2 2 2 2 0 0 0 2 2 2
2 1 1 1 1 1 1 1 1 1 1 1 1 1 1 1 1 1 1 1 1 1 1 2 2 2 2 2 2 0 3 0 0 0 0 0 2 2 2 2 2 2 2 0 0 0 0 3 3 2
2 2 2 2 1 1 1 1 1 2 2 2 2 2 2 2 2 2 2 2 2 1 1 1 1 1 1 1 2 2 2 2 2 2 2 2 2 2 2 2 2 2 0 0 0 0 3 3 3 2
2 2 2 2 2 2 2 2 2 2 2 2 2 2 2 2 3 3 3 3 2 2 2 2 2 1 1 1 1 1 1 1 1 1 1 1 2 2 2 2 3 3 0 0 0 0 0 3 3 2
2 3 3 2 2 2 2 2 2 2 2 3 3 3 3 3 3 3 3 3 3 3 3 3 2 2 1 1 1 1 1 1 1 1 1 1 1 1 1 2 2 3 0 0 0 0 0 2 2 2
2 3 3 2 2 4 4 4 4 2 2 3 3 3 3 3 3 3 0 0 0 0 0 0 3 2 2 1 1 1 1 1 1 1 1 1 1 1 1 2 2 3 0 0 0 0 0 2 2 2
2 3 3 2 2 4 4 4 4 2 2 3 3 3 3 3 3 0 0 0 0 0 0 0 0 3 2 1 1 1 1 1 1 1 1 1 2 2 2 2 3 0 0 0 0 0 0 2 2 2
2 3 3 2 2 4 4 4 4 2 2 3 3 3 3 3 0 0 0 0 0 0 0 0 0 3 2 2 2 2 2 2 2 2 2 2 2 3 3 3 3 3 0 0 0 0 0 3 2 2
2 3 3 2 2 4 4 4 4 2 2 3 3 3 3 3 0 0 0 0 0 0 0 0 0 0 0 0 0 0 0 0 3 3 3 3 3 3 3 3 3 3 0 0 0 0 0 3 3 2
2 3 3 3 3 5 5 5 5 3 3 3 3 3 3 3 3 0 0 0 0 0 0 0 0 0 0 0 0 0 0 0 0 3 3 3 3 3 3 3 3 3 0 0 0 0 0 3 3 2
2 3 3 3 0 0 0 0 0 0 3 3 3 3 3 3 3 3 0 0 0 0 3 3 3 3 0 0 0 0 0 0 0 0 3 3 3 3 3 3 3 3 3 0 0 0 0 3 3 2
2 3 3 0 0 0 0 0 0 0 0 3 3 3 3 3 2 3 0 0 0 0 3 2 3 3 3 3 3 0 0 0 0 0 0 3 3 3 3 3 3 3 3 0 0 0 0 3 3 2
2 3 0 0 0 0 0 0 0 0 0 0 3 3 3 2 2 2 0 0 0 0 2 2 2 3 3 3 3 3 0 0 0 0 0 0 3 3 3 3 3 3 3 0 0 0 0 3 3 2
2 3 3 0 0 0 0 0 0 0 0 0 3 3 2 2 2 2 0 0 0 0 2 2 2 2 3 3 3 3 3 0 0 0 0 0 3 3 3 3 3 3 3 0 0 0 0 3 3 2
2 3 0 0 0 0 0 0 0 0 0 0 2 2 2 2 2 2 5 5 5 5 2 2 2 2 2 2 3 3 3 3 0 0 0 0 0 3 3 3 3 3 0 0 0 0 0 3 3 2
2 3 3 0 0 0 0 0 0 0 0 2 2 1 1 1 1 1 1 5 5 1 1 1 1 1 1 2 3 3 3 3 0 0 0 0 0 0 3 3 3 3 0 0 0 0 0 3 3 2
2 3 3 0 0 0 0 0 0 0 2 2 2 1 1 1 1 1 1 5 5 1 1 1 1 1 1 2 3 3 3 3 3 0 0 0 0 0 0 3 3 3 0 0 0 0 0 3 3 2
2 3 3 0 0 0 0 0 0 0 2 2 2 1 1 1 1 1 1 5 5 1 1 1 1 1 1 2 3 3 3 3 3 3 0 0 0 0 0 0 3 0 0 0 0 0 0 3 3 2
2 3 0 0 0 0 0 0 0 0 2 2 2 1 1 1 1 1 1 5 5 1 1 1 1 1 1 2 3 3 3 3 3 3 3 0 0 0 0 0 0 0 0 0 0 0 3 3 3 2
2 3 0 0 0 0 0 0 0 0 0 2 2 1 1 1 1 1 1 5 5 1 1 1 1 1 1 2 3 3 3 3 3 3 3 3 0 0 0 0 0 0 0 0 0 0 0 3 3 2
2 3 0 0 0 0 3 3 0 0 0 0 2 1 1 1 1 1 1 5 5 1 1 1 1 1 1 2 3 3 3 3 3 3 3 3 0 0 0 0 0 0 0 0 0 0 0 3 3 2
2 3 0 0 0 0 3 3 0 0 0 3 2 2 2 2 2 2 5 5 5 5 2 2 2 2 2 2 3 3 3 3 3 3 3 0 0 0 0 0 2 2 2 0 0 0 0 0 3 2
2 0 0 0 0 0 3 3 0 0 0 2 2 2 2 2 2 2 0 0 0 0 2 2 2 2 2 3 3 3 3 3 3 3 0 0 0 0 0 2 2 1 2 2 0 0 0 0 0 2
2 0 0 0 0 0 3 3 0 0 0 2 2 2 2 2 2 2 0 0 0 0 2 2 2 2 3 3 0 0 0 3 3 3 0 0 0 0 2 2 1 1 1 2 2 0 0 0 0 2
2 0 0 0 0 3 3 3 0 0 0 3 2 2 2 2 2 2 0 0 0 0 2 2 2 3 3 0 0 0 0 3 3 3 0 0 0 2 2 1 1 1 1 1 2 2 0 0 0 2
2 0 0 0 3 3 3 3 0 0 0 3 3 2 2 2 2 2 0 0 0 0 2 2 3 3 0 0 0 0 3 3 3 3 0 0 0 2 1 1 1 1 1 1 1 2 0 0 0 2
2 0 0 0 3 3 3 3 3 0 0 0 3 3 2 2 2 2 0 0 0 0 2 3 3 3 0 0 0 3 3 3 3 3 0 0 0 2 2 1 1 1 1 1 2 2 0 0 0 2
2 0 0 0 0 3 3 3 3 0 0 0 3 3 3 2 2 2 0 0 0 0 0 3 3 0 0 0 3 3 3 3 3 3 0 0 0 0 2 2 1 1 1 2 2 0 0 0 0 2
2 0 0 0 0 3 3 3 3 0 0 0 0 3 3 3 3 0 0 0 0 0 0 0 0 0 0 3 3 3 3 3 3 3 3 0 0 0 0 2 2 1 2 2 0 0 0 0 3 2
2 2 0 0 0 2 3 3 3 3 0 0 0 0 3 3 3 0 0 0 0 0 0 0 0 0 3 3 3 3 3 3 3 3 3 0 0 0 0 0 2 2 2 0 0 0 0 3 3 2
2 2 0 0 0 2 3 3 3 3 3 0 0 0 0 3 3 0 0 0 0 0 0 0 0 3 3 3 3 3 3 3 3 3 3 3 0 0 0 0 0 0 0 0 0 0 3 3 3 2
2 2 0 0 0 2 2 3 3 3 3 0 0 0 0 0 0 0 0 0 0 0 0 2 2 2 2 2 2 2 2 2 2 2 3 3 3 0 0 0 0 0 0 0 0 0 3 3 3 2
2 2 0 0 0 2 2 3 3 3 3 3 0 0 0 0 0 0 0 0 0 0 0 2 4 4 4 4 4 4 4 2 2 2 2 3 3 3 0 0 0 0 0 0 0 3 3 3 3 2
2 2 0 0 0 0 2 2 3 3 3 3 3 0 0 0 0 0 0 0 0 0 0 2 4 4 4 4 4 4 4 2 2 2 2 3 3 3 3 3 3 3 3 3 3 3 3 3 3 2
2 2 0 0 0 0 0 2 3 3 3 3 3 0 3 0 0 0 0 0 0 0 0 2 4 4 4 4 4 4 4 2 2 2 2 2 2 2 3 3 3 3 3 3 3 3 3 3 2 2
2 2 0 0 0 0 0 2 2 3 3 3 3 3 0 2 2 2 2 2 2 0 0 2 4 4 4 4 4 4 4 2 2 2 1 1 1 2 2 2 2 2 2 2 2 2 2 2 2 2
2 2 3 0 0 0 0 2 2 3 3 3 3 3 3 2 2 2 2 2 2 3 3 2 2 2 2 2 2 2 2 2 2 2 1 1 1 1 1 1 1 1 1 1 1 1 1 1 1 2
2 3 3 3 0 0 0 0 2 2 2 3 3 3 3 2 2 2 2 2 2 3 2 2 2 2 2 2 2 2 2 2 2 2 2 1 1 1 1 1 1 1 1 2 2 2 2 2 2 2
2 3 3 3 3 0 0 0 0 2 2 2 2 2 2 2 2 2 2 2 2 2 2 2 2 2 2 2 2 2 2 2 2 2 2 2 2 2 2 2 2 2 2 2 2 2 2 2 2 2
2 3 3 3 3 3 0 0 0 0 0 0 0 0 2 2 2 2 2 2 3 0 0 0 0 0 0 0 0 0 0 0 0 0 0 0 0 2 2 2 2 2 2 0 0 0 0 2 2 2
2 3 3 3 3 3 3 0 0 0 0 0 0 0 0 0 0 0 0 0 0 0 0 0 0 0 0 0 0 0 0 0 0 0 0 0 0 0 0 0 0 0 0 0 0 0 0 2 2 2
2 2 3 3 3 3 3 3 3 3 3 0 0 0 0 0 0 0 0 0 0 0 0 0 0 0 3 3 3 3 3 0 0 0 0 0 0 0 0 0 0 0 0 0 0 0 0 2 2 2
2 2 2 2 2 2 2 2 2 2 2 2 2 2 2 2 2 2 2 2 2 2 2 2 2 2 2 2 2 2 2 2 2 2 2 2 2 2 2 2 2 2 2 2 2 2 2 2 2 2
